--------------------------------------------------------------------
------L-------------------------------------------------------------
--------------------------------------------------------------------
--------L------------------S----------------------------------------
---------------------------S----------------------------------------
---------------------------S----------------------------------------
-----------L---------------S----------------------------------------
------------------/^\------S----------------------------------------
----------------SSCCCSS----S----------------------------------------
--------L------------------S----------------------------------------
--------------------------------------------------------------------
--------------------------------------------------------------------
-------------S--------------------------------------PPSS------------
-----------SS-S------------S------S---------------------------------
---------------S-----------S------SS-----SS-------------------------
-----P----------S-----LL---S------SSS------------CCCPP--------------
-----------------S---------S------SSSS------------------------------
--------S---------S--------S------SSSSS-----------------------------
SSSSSSSSSSSSSSSSSSSSSSSSSSSSSSSSSSSSSSSSSSSSSSSSSSSSSSSSSSSSSSSSSSSS