----------------------------------
----------------------------------
----------------------------------
---------------------------S------
---------------------------S------
---------------------------S------
---------------------------S------
---------------------------S------
----------------SSSSSSS----S------
--------L------------------S------
----------------------------------
----------------------------------
-------------S--------------------
-----------SS-S------------S------
---------------S-----------S------
-----L----------S-----LL---S------
-----------------S---------S------
--------S---------S--------S------
SSSSSSSSSSSSSSSSSSSSSSSSSSSSSSSSSS