----------------------------------
------L---------------------------
----------------------------------
--------L------------------S------
---------------------------S------
---------------------------S------
-----------L---------------S------
------------------/^\------S------
----------------SSSCSSS----S------
--------L------------------S------
----------------------------------
----------------------------------
-------------S--------------------
-----------SS-S------------S------
---------------S-----------S------
-----L----------S-----LL---S------
-----------------S---------S------
--------S---------S--------S------
SSSSSSSSSSSSSSSSSSSSSSSSSSSSSSSSSS